%%%%%%%%%%
%  % %  %%
% %%   %F% 
%S   %   %
%%%%%%%%%%